111111111111111111111111111111111
100001000000000000001000000000001
100001000000000000001000000000001
100001111111000111001111000000001
100000000000000000000001000000001
10000P0000000000000000011110000E1
100000000000000000000001111000001
10000000000C000000000001111000001
100000000000000000000001111000001
111111100000000000000000000000001
100000000000000000000100000000001
111111100000000000000000000000001
111111111111111111111111111111111