111111111111111111111111111111111
1C100100000000000000100000C100101
101001000000000000001000000110001
100001111111000111001111000100011
100000000000000000000001000000101
1000000P00000000C0000000111100001
1000C00000E0010000000011110001011
100000000000C10100000001111011101
100000000000000000000001111000001
111111100000000000000000000000001
111111100000000000000000000001101
111111100000000000000010000000011
10000C000000000010000000100100001
1111111100000000000100C000C0001C1
111111111111111111111111111111111