111111111111111111111111111111111
10000100000000000000100000C0000P1
100001000000000000001000000000001
100001111111000111001111000000001
100000000000000000000001000000001
100000000000000C00000001111000001
1000C0000000000000000001111000001
100000000000C0E000000001111000001
100000000000000000000001111000001
111111100000000000000000000000001
1000000000C0000000000100000000001
1111111100000000000000C000C000001
111111111111111111111111111111111