111111111111111111111111111111111
10000100000000000000100000C000001
100001000000000000001000000000001
100001111111000111P01111000000001
100000000000000000000001000000001
100000000000000C00000001111000001
1000C0000000000000000001111000001
100000000000C0E000000001111000001
100000000000000000000001111000001
111111100000000000000000000000001
1000000000C0000000000100000000001
111111110000000000000000000000001
111111111111111111111111111111111