111111111111111111111111111111111
1C100100000000000000100000C0001P1
101001000000000000001000000000101
100001111111000111001111000000101
100000000000000000000001000000101
100000000000000C00000001111000101
1000C0000000001000000001111000101
100000000000C1E100000001111000101
100000000000000000000001111000001
111111100000000000000000000000001
111111100000000000000000000000001
111111100000000000000000000000001
10000C000000000010000000000100001
1111111100000000000000C000C000001
111111111111111111111111111111111