1111111111
1000000001
1000000011
1011111111
100P100001
1110001101
1000000001
1CC0000001
1000E00001
1111111111