111111111
10E0000P1
1C0000101
101C00001
111111111