111111
100P01
1010C1
1E1001
111111