1111111111111
1C1100C1P0001
10100100001E1
1000110010101
1111111111111